TILEMAP
32 20 							-- Size of tile map in tiles
18 18 							-- Tile size & block size
images/tilesheet.png 	-- Tilesheet
16 8 								-- Number of tiles in tilesheet
082123082124124123124123082123124124123123124082123124123123124123082123124124082123124124082123
123082123123124082123123123124123082124124123124071068067066068067100066068069065068067066066100
068100068066069065066066068066068067070123082123108094094094094094094037037037094094094094094094
094094094094094094094094094094094094107124123123108094094094094094094094094094094094094094094094
094094094094094094094094094094094094091123124082098081081081081081081081081081081081081081081081
081053114094094094094094094094094094075123124123082123096082123124082082123124082124123082124123
066068100094094094094094094094094094091071066068100100112099067032016016016016016016016032016016
094094037113053053053114037094094094094094094094094094112094094048094094094094094094094048094094
094094037099067125066100037094094094094094094094094094112094094048094094094094094094094064094094
094094094094094126094094094094094094094094094094094094112094094048094094037037113110110080110110
094094094094094126094094094094094094094094094094094094112094094064094094094094099067070082082082
094094037113053127053053053053053053053053053053053053128053053080053053110114037037091123124123
094094094099099067100032016016016016016016016016016016016016016032068067125100037094107124123123
053053114094094094040048094094094094094094094043094094094094094048094094126094094094091082082124
082124071094094094040048094094094094094094043043094094094094094048094094126094094094107124123124
123082108094094094040048040094094094094007008009094094094094094048094094126094094094107123124123
082123092094094094040048094094094094094023024025094094094094094048094094126094094094107124082123
082082108094094094040064094094094094043039040041094094094094094064094094126094094094091123123124
123124098110110110110080110110110110110055056057110110110110110080110110127110110110097124082123
124123082123082123124082123124123082123123124124082123123082123124124123082123124123123082123124