TILEMAP
32 20 							-- Size of tile map in tiles
16 16 							-- Tile size & block size
images/tilesheet.png 	-- Tilesheet
16 8 								-- Number of tiles in tilesheet
082123124124123082123123082082124123124124082124123123124082082124124123123123082123124082124123
071066066067066069065066070071067066067066066099068100069065066066070071099068066067069065100070
092094094094094094094094094094094094094094094094094094094094094094094094094094094094094094094075
076094094094094094094094094094094094094094094094094094094094094094094094094094094094094094094091
108094077078079094094094094094094094094094094094094094094094094094094094094094094094094094094107
076094093094095094094094094094094094094094094094094094094094094094094094094094094094094094094091
092113109110111110110110110114094094094094094094094094113110110110110110110110114094094094094075
076099066067066068066096066100094094094094094094094094099096066068066069065066100094094094094107
092094094094094094094112094094094094094094094094094094094112094094094094094094094094094094094091
108094094094094094094112094094094094094094094094094094094112094094094094094094077078079094094075
076094094094094094094112094094094094094094094094094094094112094094094094094094093094095094094107
098110110110110110110128110110110114094094094113110110110128110110110110110110109110111110110097
123124082082124123123124124082123124094094094082123123124123082124124071096070082123082124123082
071067066069065066100068066070071100094094094099068066066067066069065094112094068100070071066070
108094094094094094094094094094094094094094094094094094094094094094094094112094094094094094094091
076094094094094094094094094094094094094094094094094094094094094094094094112094094094094094094107
092094094094094094094094094094094094094094094094094094094094094094094094112094094094094094094075
098113110110110114072073073073072073072072072073073072072113110110110110128110110110110114094091
071066067096066099088089089088089088089089089088088089088100069065066068066066099067066100094107
108094094112094094094094094094094094094094094094094094094094094094094094094094094094094094094075