TILEMAP
32 20 							-- Size of tile map in tiles
16 16 							-- Tile size & block size
images/tilesheet.png 	-- Tilesheet
16 8 								-- Number of tiles in tilesheet
092094094112094094094094094094094094094094094094094094094094094094094094094094094094094094094075
108094094112094094094094094094094094094094094094094094094094094094094094094094094094094094094107
076094094112094094094094094094094094094094094094094094094094094094094094094094094094094094094094
108094094112094094094094094094104105106094094094094094094094094094094094094094094094094094094094
092094094112094094094094094094120121122094094094094094094094094094094094094094094094094094094094
076094094112094094094094094094094094094094094094113110110110110110110110110110110110110110110110
108094094112094094094094094094094094094094094094100068066066099096100067065069066066068066067070
092094094112094094094094094094094094094094094094094094094094094112094094094094094094094094094075
098110110128110110110114094094094094094094094094094094094094094112094094094094094094094094094107
071066067066066066096099094094094094094094094094094094094094094112094094094094094094094094094107
092094094094094094112094094094094094094094094094094094094094094112094094094094094094094094094075
108094094094094094112094094094094094094094094094094094094094094112094094094094094094094094094091
076094094094094094112094094094094094094094094094094094094094094112094094094094094094094094094075
092094001002003094112094094094094094094094094094094094094094094112094094094094094094094094094107
076094017018019094112094094094094094094094094094094094094094094112094094094094094094094094094075
108094033034035094112094094094094094094094094094094094094094094112094094094094094094094094094091
098110049050051110128110110110110110110110110110110110110110110128110110110110110110110110110097
101102101101102101102102102101101101102101102101102102101101102102101101101102101102102101102101
117118118118117117118118117117117118118117118117118118117118117117118118117117117118117118118117
118117118117118118118117117118118117117117118117118117118118117118117117117118117118118117117118


