TILEMAP
32 20 							-- Size of tile map in tiles
16 16 							-- Tile size & block size
images/tilesheet_green.png 	-- Tilesheet
16 8 								-- Number of tiles in tilesheet
071068067066069065067066068067070071067068066070071068067070071067066068069065067068066067068069
092094094094094094094094094094094094094094094094094094094094094094094094094094094094094094094094
076094094094094094094094094094094094094094094094094094094094094094094094094094094094094094094094
092094094094094094094094094094094094094077078079094094094094094094094094094094094094094094094094
076094094094094094094094094094094094094093094095094094094094094094094094094094094094094094094094
098053053053110110110053053053053053053109110111053053053053053053053053053053053053053053053053
071066096067066067068069065066068067067068069065066067068067096066069065068069065068066067068070
092094112094094094094094094094094094094094094094094094094094112094094094094094094094094094094075
076094112094094094094094094094094094094094094094094094094094112094094094094094094094094094094091
098053128053053053053053053053053053114094094094094094094094112094094094094077078079094094094075
071069065066067068067070071066125067068094094094094094094094112094094094094093094095094094094075
076094094094094094094094094094126094094094094094113053053053128053053053053109110111081081081097
092094094094094094094094094094126094094094094094065068067066068067069065068067069065066068066067
108094094094094094094094094094126094094094094094094094094094094094094094094094094094094094094094
076094094094094094094094094094126094094094094094094094094094094094094094094094094094094094094094
098053053053053053053053053053127053053053053114094094094094094094094113053053053053053053053053
071066068067096069065066067069065067068069065067094094094094094094094068066096068066068069065070
092094094094112094094094094094094094094094094094094077078079094094094094094112094094094094094075
076094094094112094094094094094094094094094094094094093094095094094094094094112094094094094094075
098053053053128053053053053053053053053053053053053109110111053053053053053128053053053053053097