TILEMAP
32 20 							-- Size of tile map in tiles
16 16 							-- Tile size & block size
images/tilesheet.png 	-- Tilesheet
16 8 								-- Number of tiles in tilesheet
071068066067099068066067100100068067066068069065099067066068100099070071066066068067068066066068
108094094094094094094094094094094094094094094094094094094094094094094094094094094094094094094094
092094007008009094094094094094094094094094094094094094094094094094094094094094094094094094094094
076094023024025094094094094094094094094094094094094094073073073073073073073073073073073073073073
092094039040041094094094094094094094094094094094094094125088089089089088089088089089089088125089
098053055056057114072073073073073073073073072073073073127094094094094094094094094094094094126094
071066066068066100088089125089089089089088089089088089088094094084084084084084084084094094126094
092094094094094094094094126094094094094094094094094094094094094070123082123124123071094094126094
116118117118118117118117117118117117118117117118117118117118117087123124124124123116117118118117
116118118118117117118117118118118118118118117118117118117117118087123124123082123116118117118117
116118117118118118118118117117118117118118118118118117118118117087124082124124124116117118118118
103085086085086086085085086086085086085085086086085086086085086119123124123123123103085085086085
124123082123082124124124123082124082124082123124082124082123082124082123123082123123082082123124
071068066066068100067032016016016016016016016032016016016016016016016016016016016016016016016016
076094094094094094094048094094094094094094094048094094094094094094094094094094094094094094094094
092094001002003094094048094094094094094094094048094094094094094094094094094094094094094094094094
108094017018019094094048094094094094094094094048094094094094094094094094094094094094094094094094
092094033034035094094064094094094094094094094064094094073072073072073073073073073073073073072073
098053049050051053053080053053053053053053053080114094089088089089088089125089089089088089088089
123082123123082071100067068099066067068066070071100094094094094094094094126094094094094094094094