TILEMAP
32 20 							-- Size of tile map in tiles
16 16 							-- Tile size & block size
images/tilesheet.png 	-- Tilesheet
16 8                                             	-- Number of tiles in tilesheet
066068068066067066068068099067066068068066067067066099066069065066068066067099066068067099070123
094094094094094094094094094094094094094094094094094094094094094094094094094094094094094094091082
094094094094094094094094094094094094094094094094094094094094094094094094094094094094094094107124
072073073073072073073072073073073072073073073072072073073073072073073094094094094094094094107123
088089089125088089088089089089088089089125089089088089089089088125089094094094094094094094091124
094094094126094094094094094094094094094126094094094094094094094126094094094094077078079094075082
094094094126094094094094094094094094094126094094094084084084094126094094094094093094095094075123
094094094126094094094094094094094094094126094094094070082071094126094094113053109110111053097124
117117117117117117117117117117117117117117117117117087123092094126094094099068068066068066070123
117117117117117117117117117117117117117117117117117087124092094126094094094094094094094094107082
117117117117117117117117117117117117117117117117117087082092094126094094094094094094094094107123
086085085086085086085085086085085085086086085085086119123098072127072072072072072073094094075124
124123123082082123124124123123123082082123123124082123071089089089089089089089125089094094091123
016016016016032099100068070071099068066068066100099066094094094094094094094094126094094094107082
094094094094048094094094094126094094094094094094094094094094094094094094094094126094094094075082
094094094094048094094094094126094094094094094094094094094094094094094094094094126094094094091123
094094094094064094094094094126094094094094094094094094094094094094094094094094126094094094107123
073073072073080073073094094126094094094094094094094094094094094094094094094094126094094094075123
089088089089088089089073073127073073073073073073073073073073073073073073073073127073113053097124
094094094094094094094089088089088089089089088089089088089089088089088089089089089089066070124123