TILEMAP
32 20 							-- Size of tile map in tiles
18 18 							-- Tile size & block size
images/tilesheet.png 	-- Tilesheet
16 8 								-- Number of tiles in tilesheet
071066068066069065099067068066066067100066071070099068066067100068066066069065099067066067066070
092094094094094094094094094094094094094094094094094094094094094094094094094094094094094094094075
108094094094094094094094094094094094094094094094094094094094094094094094094094094094094094094091
094094094094094094094094094094094094094094094094094094094094094094094094094094094094094094094107
094094094094094094094094094094094094094094094094094094094094094094094094094094094094094094094075
094094094094094094094094094094094094094094094094094094094094094094094094094094094094094094094107
110110110110110114094094094094094094094094094094094094094094094094094094094094094007008009094091
082123071066067100094094094094094094094094094094094094094094094094094094094094094023024025094107
123124092094094094094094094094094094094094094094094094094094094094094094094094094039040041094075
124123108094094094113110110114072073073073072073072113110110114094094094094113110055056057110097
123082076094094094099068032100088089089089088089089099066096100094094094094099096066070123124082
124123108094094094094094048094094094094094094094094094094112094094094094094094112094091082123124
124082076094094094094094048094094094094094094094094094094112094094094094094094112094075123082124
082124092094094094094094048094094094094094094094094094094112094094094094094094112094107082123082
123082108094094094094094048094094094094094094094094094094112094094094094094094112094091124082123
124123076094094094094094048094094094094094094094094094094112094094094094094094112094075082123124
123124108094094094094094064094094094094094094094094094094112094094094094094094112094075123082123
082123098110110110110110080110110110110110110110110110110128110110110110110110128110097082124082
101102101101102101102102102101101101102101102101102102101101102102101101101102101102102101102101
117118118118117117118118117117117118118117118117118118117118117117118118117117117118117118118117
118117118117118118118117117118118117117117118117118117118118117118117117117118117118118117117118


