TILEMAP
32 20 							-- Size of tile map in tiles
18 18 							-- Tile size & block size
images/tilesheet.png 	-- Tilesheet
16 8 								-- Number of tiles in tilesheet
067068066069065067068067066068069065068070071067069065068067068067069065068067066068067068066070
094094094094094094094094094094094094094094094094094094094094094094094094094094094094094094094091
094094094094094094094094094094094094094094094094094094094094094094094094094094094094094094094075
094094094094094094094094094077078079094094094094094094094094094094094094094094094094094094094107
094094094094094094094094094093094095094094094094094094094094094094094094094094094094094094094075
081081081081081081081081081109110111081081081081081081081114094094094094113081081081081081081097
066067068069065068066069065068067066068069065067068067066068094094094094065067069065066096068070
094094094094094094094094094094094094094094094094094094094094094094094094094094094094094112094075
094094094094094094094094094094094094094094094094094094094094094094094094094094094094094112094107
094094094094094094094077078079094094094094094094094113081081081081081081081053053053114112094075
094094094094094094094093094095094094094094094094094068067096066067068069065068066067069112094091
081081081081081081081109110111081081081081081114094094094112094094094094094094094094094112094075
068067066068096068069065068067066096069065068069094094094112094094094094094094094094094112094107
094094094094112094094094094094094112094094094094094094094112094094094094094094094094094112094091
094094094094112094094094094094094112094094094094094094094112094094094094094094094094094112094075
053053053053128053053053053053053128053053053053053053053128053053053053053053053053053128053097
071067096069065067068067066068096069065068067070071067069065068067066068067066125069065068066070
092094112094094094094094094094112094094094094075076094094094094094094094094094126094094094094091
076094112094094094094094094094112094094094094091108094094094094094094094094094126094094094094107
108094112094094094094094094094112094094094094107092094094094094094094094094094126094094094094075